########################
########################
########################
########################
########################
##### @@@@@!       #####
############  ###  #####
##### !!!! #  #@#  #####
#####  #   #  #@#  #####
#####  #   #   !#  #####
########        #  #####
#####  #! @@@@ !#  #####
#####  #        #  #####
#####  ##########  #####
#####  !     #     #####
#####  !  @@ #  @  #####
#####     @@ #  @  #####
#####    #####  !  #####
#####  P           #####
########################
########################
########################
########################
########################